                                        ███  ███                                       ██ ███████                                           
                                        ███ ████                 ██                    ███████████                                          
                                        ███████                  ████  ██            ███████ █████                                          
                                        ███████              ██ █████  ██            ██████████████                                         
                                          ██████         ██████████ ██████        █████████████████                                         
                                         █████████     █████████████████████ ███ ████ ████████████████                                      
                                      █████████████    ███████████████ ██ ██ ███████  ████████████ ███                                      
                                      ███████████████  █████████████ ████████ ████████ ██████████████████                                   
                                   ██████████████████████████████████████████ █████████████████ █████████                                   
                                   ███████████████████████████████ █████ ██ █████████████████████ ███████                                   
                                 ███████████████████ █████████████████████████████   ████████████████████                                   
                           █████ ███████████████████████ ███ ██████████ ████████████████████████████████                                    
                  ██       ████████████ ███████████████████████████████████ ████████████ ████████████ ████                                  
                  ██   ██ ████████████████ ████████████████ ████████████████████████████████████████████████                                
                  ██ █████████████ █████████████████████████████████████████████████████████████████████████                                
                  ██ ███████████ ██ █████████████ █████████████████████████████████████████████ ████ ███████                                
                  █████████████████████████████████ ██ █████████████████████████████████████████████████████                                
                  █████████████████████████████████████████ ██████████████████ ████ ████████████████████████ ████       ██                  
                   ██████████████████████████████████████████████████████████████████████ ████████████████████████ ███  ███     ██          
                   █████ ████████████████████████████████████████████████████████ ████████████████████████████████ ████████  █████          
                 ████████████████████████████████████████████████████████████████████████████████████████████████   ██████ ███████          
                 ████ ████████████████████████████████████████ █████████████████████  ███████████████ ████████████ ██████  ██████           
                 ███████████████████████████████████████████████████████████████████████████████████████████████████████████████████        
                 ████████████████████████████████████████████████████████████████████████████████████████████████ ███████████████████       
                 ███████████████████████████████ ████████████████████████████████████████████████████████████████████████████████████       
                 ██████████ ██████████████████████████████████████████████████████████████████████████████████ ██████████ ██████████        
                  █████████████████████████████████ ██████████████████ █████████████████████████ ██████████████████ ██████████████████      
                   ██████████████████████████████████████████ ████████████████████████████████████████████████████████████████████████      
                ██████████████ ████████████ ██████████████████████ ███████████ ██ ██████████ ██████████████████████████████████████████     
                ██████████████████ ████████████████████████████████████████████████████████████████████████ ████████ ██████████████████     
                  ███████████████████████████████████████████ ███████████████████████████████ ██████████████████ ███████████ ████████       
                  █████████████ ██████████████████████████████████ ███ ██████████████████████████████████████████ █████████████████████     
                   ███████████████████████████████████████ ████████████████████████████ ████████████████████████████ ██████ ███████████     
                 ███████████████████████████████████████████████████████████████████████████████████████████████████████████ ███████████    
                 █████████████████████████████████████████████████████ ███████████████ ██████████████ ███████████ ██████████████████████    
               ████████████████████████████████████████████████████████████████████████████████████████████████████████████████████████     
         ██  ███████████████████████ ████████ █████████████ █████████████████ ██████████████████████████████████████ ██████████████████     
         █████████ ████████████████████████████████████████████████████████████████████████ ████████████████████████████ ██ ███████████     
         ███████████████████████████████████████████████ ██████████████████████████ ██████████████████████████████████████████████   ███  ██
        ████████████████████████████████████ █████████████████████████████████████████████ ███████████████████████ ████████████████  ███████
        ███████████████████████████████████████████████████████████████████████████████████████████████████████████████████████████ ████████
         ██ ███ ████████████████████████████████████████ █████████████████████████████████████████████████████████████████████████████████  
        ███████████ ██████ ███████████████████████████████████████████████████████████████████████████████████████████████████████████████  
       █████ █████ ███████████ ███████ ██ ████████████████████████████████████████████ ██████████████████████████████████████ ████████████  
       █████████████████████████████████████████████████████████████████████████ █████████ █████████ ████████████████████████████████████   
        █████████████████████ ███████████████ █████ ███████████████████████ ██████████████████████ ██ ████ ████████████████████████ █████   
       ███████████████████████████████ ██  ███████████████████████████████████████████ ████████████████████████████████████████████         
       █████████████████████████████████████████ ██████ █████████████████████████ ███████████████████████████████ ████████ ████████         
      █████████████████████████████████████████████████████████████████████ ███████████████████████ ███████████████████████████████         
      █████████████ ████████████████████████████████████████████████████████████ █████████ ████████████████████████████████████████         
        ███ ███████████████████████████████ █████████████████████████████████████ ███████████████████████████████████████████ █████         
        ███ ██████████████████████████████████ ███████████████████████████████████████ █████████████████ ███████████████████████████        
       █████████ ██ ██████████████████ █████████████████████████████████████ █████████████ █████████████████████████████████████  ██        
      ██████ ██████████████████████████████ █████████████████████████████████████████████████████████ ████████████████████████████████      
      █████████████████████████████████████████ ████ ██ ██████████████████████████████████████████████████████████████ ███████████████      
         ████████████ ██████████████ ██████████████████████ ████████████████████████████████████████████████████████████████ ████ ██        
  ██     ████████████████████████████████████████████████ █████████   ██████████████████████ █████████████ ██ ████████████████████████      
  ███   ██████████████████████████████████████████████████████  ███   ███████████████████████████████████████████████████ █████████████     
  █████ ███████████████████████ ████████ █████████████████████  ██      ██ ██████ ██████████████████ ████████████████████████████████████   
████ ██ ████████████████████████████████████ ███████████████    ██      ██  █████ ██ ███████ █████████████████████████████████████████ ███  
████████████████████████████████████████████████████████████               ██████████████████████ █████████████████████████ ██████████████  
 ████████████████████████████████████████████████████████                  ████████████████████████████████████████████████████ ███████████ 
 ██████████████ █████████████████████████████████████████                 ██████████████████████████████████████████████████████████ ██████ 
  ████████ ██████████████████████████████████████████████ ██              ███████   ████ █████████████████████████████████████████      ██  
    ███████████████████████ ████ ███████████ █████████████████              ████   █████████ █████████████████████████████████████          
      █████████████ ██████████████████████████████████████████                    █████████ ██████████████████████████████████████          
     ██████████████████████████████████ ███████ ██████████████                    █████ ████████████████████████████████  ██████            
     █████████████████████████████████████████████████████████                     ████████████████████████████████████████████             
         ███████ ███████████████████ █████████████████  ██  ██                     ███████████████████████ ████████ ███████████             
  ████████████████████████████████████████████████████████                      ████████████████ ███████████████████████████████            
  ███████████████ ██ ███████████████████████████████████                        █████████████████████████████████ ███████████████           
 █████████████████████████████████████████████████████████                      █████████████████████████████████████████████████           
 ██████████████████████████████████████████████████████████                        ██████████████████████████████████████████████           
 ██████████ ██████████████████████████████████████ ████████                        █████ ██████████████████████████████████████ ████        
 ███████████████████████ █████████████████████████████ ██                            ███████████████████████████████████████ ██ ████        
  █████████████████████████████████████ ███████████████ ███                           ███████████████████████████████████████████████       
  █████ █████████████ ███████████████████ █████████████ █████                    ███ ███████████████████████████████ █████████████████      
    █████████████████████████████████████████████████    ████                    ███████████████████████████ █████████████████████████      
    ████ ██ ██ █████ █████████████████ ██████████████ ██████ ██                 ███████████████████████████████████████████████  ██         
    ████ █████████████████████████ ██████████████████████████████   ████ ██     ████ ████ ██ █████ ███████████ █████████ ██████             
      ████████████████████████████████████████████████ ████ █████   ████████  ████████████████ ███████████ ████████████████████             
      ██████████████████████████████████████████████████████ ████   ████████  █████████████████████████████ ███████████████████████         
         ████████████████████ ██████████████████████████████████████ ███████  ████████ ████████████ █████████ ████████████ ████████         
        ██████████████████████████████████████████████████ ██████████████████████████████████████████████████████████████████████████       
        ██████████████████████████████████████████████████████ ███████████████████████████████████████ ██████████████████████████████       
        ████████████████████████████ ██ █████████ ████ ███████████████████████████ ███ ██████████████ ███████████████████████ ██████        
      ████████████████████████████ ███████████████████████████████████████████ ████████ ██████ ████████████████ ████ ██████████ ████        
      ██████████████████████████████████████████████████████████████████████████████████████████████ ███████████████████ ████████████       
       ██████ █████████████████ ███████████████████████████████ ██████████████████ █████████████████████████████████████████ ████████       
            ████████████████████████████████████ ████████████████████████████████████████████████████████████ ███████████████████████       
            ███████████████████████████████████████████████████████████████████████████████████████████████████████████████████████         
             ██ ████████████████████████████████████████████████████ █████████████████████ ████████ ██████████████████████████ ████         
          ███ ██████████████████████████████████████████████████████████████████████████████████████████████████████████████████████        
     ██████████████████████████████████████████████████████ ██████████████████████████████████████████████████ ██████████████████████       
     █████ ███████████████████ █████ █████████████████████████████████████ █████████████ █████████████████████████████████████████████      
     ███████████████████████████████████████████████████████████ █████████████████████████ ███████████████████████████████████████ ████     
      ██████████ █████████████████████████████████████████ █████████ ████████████████████████████████████████████████ █████████████████     
          ██ ██████████ ████████████████████████ ██████████████ ███████████████ ████████████████ ████████████████████████████████████████   
          █████████████████ ██████████████████████████████████████████████████████████████████████████████████████████████ ████████████████ 
           █████████████████████████████████████████████████ ███████████████████████ █████████ █████ ███████████████████████████████ ██████ 
          ███████████████████████████████████████████████████████████████████████ ███ ███████████████████████████████████████ ██████ ████   
          ████████████████████████████████ ██████████████████████████ ████ ███████████████████████████████ ███████████████████████████████  
         ██ ████████████████████████████████████████████████ █████████████████████ ███████████ █████████ █████████████████████████████████  
      █████████ ████████████████ ████████████ ███████████████████████████████████████████████ █████████████████████████████████ ██████████  
      ███████████████████████████████████████████████████████████ ██████████████████████████████████████████████ █████████████████████████  
          ██████████████████████████████████████████████████████████████████████████████████████████████████████████████████████████████████
          ██████████████████████████████ ███████████████████████ ████████████ ██████████████████████████████████████████████████████████████
           ██████████████████ ██████████████████████████████████████████████████████████████████████ ███████████████████████████████████████
           ██████████████████████████████████████████████████████████ █████████████████ ███████████████████████████████████████████ ██████  
          ████████████████████████████████████████ ████████████████████████████████████████████████ ███████████████████████████████   ████  
         ████████████████████████████████ ████████████████████████████████ ████████████████████████████████████████████████████████         
         █████████████████████████████████████████████ ██████████████████████ █████████████████████████████ █████████████████████           
         ███████████████████████████████████ ██████████████████ ████████████████████████ ██ ██ █████████████████████████████████            
         ██████████████████████████████████████████ ████████████ ███████████████████████████████████████████████ ██████ ███  ███  ██        
          ███████████ ████████████████████████ ███████████████████ ██████████ ████ █████████████████████████████████████████████████        
          ███████████████ ███████████ ████ █████████████████████████████████████████████████████████████████████████████ ███████████        
            █████████████████████ ██████████████████████ ██████████████████████████████████████████████████████████████████████ ██████ ██   
              █████████ ████████████ ███████████████████████████████████████████ █████████████████████████████████████████████████████████  
            ████████████████████████████████████████████████ █████████████████████████████████████████ ██████ ████████ ███████████████████  
            ██████ █████████ ██████ ███████████████████████████████ ████████████████████████████ ███ ███████████████████████████████    ██  
             ████ █████████████████████████████ ███████████ █████████████████████████████████████████████████████████ ████████ ████         
              █████████████████████████████████████████████████████████████████ ███████████████ ██████████████████████████████  ███         
              ████ ██████████████████████████████████████████████████████████████████████ ██████████████████████████ ████                   
            █████████████████████████████████████████████████████████████████  █████████████████████████████████████ ██                     
            ████████████ ████████████████████████████████████████████████████████████████████████████████████ ███████                       
            █████████████ ████ █████████████████████████ ██ ██ ██████████████████████████████████████████████  ███████                      
            ████████████████████████████████████████████   █████████████████████████████████ ██ ███ ████████   ███ ███                      
           ██████████████████████████ █████████████████    ██████████████  ████████████ ██ █████████████████ ████                           
           ████████ █████████████████████████████████      ██████████████    ███████████   █████████████████ ████                           
             ████████████████████████████    ████████      █████████   ██    ███████████   ████ ████████████  ██                            
               ██████████████████████████     ██ ████        ██ ████           ████████    ████ ██ ███ █████                                
                  ███████████████████████         ██         ██████            ████████                                                     
                                                   
                                                                            ██                                                      
                                                                                                                                            
                                                                                                                                            
                                                                                                                                            
                                                                                                                                            
                                                                                                                                            
